20
20
x x x g x x x x x x x x x x x x x x x x
x . x . . . . . . . x . . . . x . . . x
x . x x x . x . x . x . x . x x g x . x
x . . . . . x . x . . x x . x x x x . x
x x x x x x . . x . . . . . . . . . . x
x . x . . . . x . . . x x . x x . . . x
x x x x x x . x . . . x . . . x . . . x
x . x x x x . x . . . . . x . . . . . x
x x . . . . . x . . . x . . . x . . . x
x . x . x x x . . . . x x . x x . . . x
x x . . . . . x . . . . x . . . x . . x
x . x x x x . x . . . . . x . . . x . x
x . . . . . . x x x . . . x . . . . x x
x . x . . . . x . x . . . x . . . . . x
x . x x x x . x . x . . . . x . . . . x
x . . . . x . x . x x x . . . x . . . x
x x x x . x . x . . . x . . . x . . . x
x s x x . x . x x x . x . . . . . . . x
x s . . . x . . . . . x . . . . . . . x
x x x x x x x x x x x x x x x x x x x x
